10x10* o12
*****1****
**       *
*    * * *
*        *
**       *
* * * *  *
*    *** *
*    *   *
**       *
******2***
